11111111111111111111111111111111111111111111111111111111111111111111111111111
111C0PE00C0000C11111111111111111111111111111111111111111111111111111111111111
11111111111111111111111111111111111111111111111111111111111111111111111111111